"" ""	""	""
"" "a"	""	""  
"a" ""	"a"	"a" 
"a" "a"	"a"	"a"	  
"aaa" "a"	"aaa"	"aaa"	 
"aaa" "aa"	"aaa"	"aaa"	   
"aaa" "aaa"	"aaa"	"aaa"	   
"aaa" "aaaa"	""	""	   
"mississippi" "a"	""	""	   
"mississippi" "mississippi"	"mississippi"	"mississippi"	   
"mississippi" "mississippii"	""	""	   
"mississippi" "issi"	"ississippi"	"ississippi"	   
"mississippi" "issip"	"issippi"	"issippi"	   
"mississippi" "issipi"	""	""	   
"hello" "ll"	"llo"	"llo"	   
"abcde" "cd"	"cde"	"cde"	   
"aaabb" "baba"	""	""	   
"bbaa" "aab"	""	""	   
"aaaaa" "bba"	""	""	   
"aaaa" "baaa"	""	""	   
"abb" "abaaa"	""	""	   
"baaa" "abbb"	""	""	   
"bbb" "abbab"	""	""	   
"aab" "abbab"	""	""	   
"babba" "bbb"	""	""	   
"aaa" "aabab"	""	""	   
"aabaaaababaababaa" "bbbb"	""	""	   
"babbbbbabb" "bbab"	"bbabb"	"bbabb"	   
"bbbbababbbaabbba" "abb"	"abbbaabbba"	"abbbaabbba"	   
"ababbbbaaabbbaaa" "bbbb"	"bbbbaaabbbaaa"	"bbbbaaabbbaaa"	   
"aaabaaabbbabaa" "babb"	""	""	   
"aabaabbbaabbbbabaaab" "abaa"	"abaabbbaabbbbabaaab"	"abaabbbaabbbbabaaab"	   
"baabbbbababbbabab" "abbab"	""	""	   
"bbaabaaabababbbbba" "aab"	"aabaaabababbbbba"	"aabaaabababbbbba"	   
"bababbababbbabbaa" "abbba"	"abbbabbaa"	"abbbabbaa"	   
"aaaabbbababb" "baa" "" ""
"abbbbbaabbaabaabbbaaaaabbabbbabbbbbaababaabbaabbbbbababaababbbbaaabbbbabaabaaaabbbbabbbaabbbaabbaaabaabaaaaaaaa" "abbbaababbbabbbabbbbbabaaaaaaabaabaabbbbaabab" "" ""	   
"abbbaaaaaaabbababbbbabababbbbbbbaaaaaaabbaaabbaababbbbababababaabbbbbbaaaaababbbbaaabababbbaaaabbbaabbbbbbabababbabaaaaabaabaaababbbaaabaababbaaabaaababbabbbbababaaaaaaababaabaabbaabbbaaabaaaaaa" "aabaaaabababbbabababbbaabaabaaaaabaabbbaabbbbba"	""	""	   
"aaaabaaabbabbaaaaaabbabbbaaabababaaaaabbbbbbbbbbbbbbbaabbbbabbaababbbababababaaaabbbbaaabababbbaaabbaabbabbbbbababbabbaabbbabaabaaaaabbbaaaaaabaaaabababababbaabaabbaaaaaaaababbabaa" "aabbaaaabbbbaabaaabaabbaaababbabbbbbaba"	""	""	   
"bbabbaababbaabbbbababbabbbabaaabbabaabbaabbaaabbaaabaaabbbabbabbaabbbbbbaabaabbabbabbaaabaabababbbaaabbaaaaababbbbabbbbbbbaaaabbbbbaaaaabbbabababababbbaababbbabaabbabbbaaabababbba" "abbbbbaababbaaabaaaaaaabaaabbaa"	""	""	   
"abbbabbbbbbabbbbbbaaaabaabbbabbaaabbbaabbbbbbaaabaababbabbababbbaaabaaaaabbbbbbbaaaabababbbbaaaaaaabbabbaaabbbabbbabbbbaabbababaabbbbaabaabbabbbaba" "aababbaabbababbabbbbaabaaababaababbbabbbbabbbabbbb"	""	""	   
"bbbbbbbaababbbaaaabbbbaabaaaababaababaaabababaababbbbbbaabaaaabbaabaababbbbabbabbbaaaaaabaaaaabbaabbbbaaaaaabababaaaaa" "babbbbaababababbabaaaaabaabaaaabab"	""	""	   
"babbaaaababbbabbbbbabbbbbbababababbabbabaaabababaababbbbabaabaabbbbbabaababababbabbbabaaaabbabaaabbabbbabaaaaababbabaababaabbabbaaabbbbabaaaaaabbaabbbbaabbbab" "abbbbaabbaabaaabbababbbbbbbababbbaaaaaa"	""	""	   
"babbabbbaabbbabababaaabbbbabaabbabaaabbaaaababaabbabbaaabaababaaabababbabbaaaaabbaaaabbabbbaaaabbbababaabaabaabbabbbaababaaaaabbbbbaababbabbaaaabbbaaaabbabbaababaaabab" "aabaabaaaaaaaaababbaaaabaabbab"	""	""	   
"abaaabbabbaabaababaababbabababaababbbababbaababbabbbbaababaaaaabababbbaaaabbbaabaaababbaabaaabaaaaaaaaaaababaaaaabbbaabaaaaabaabbabbaabbbbababbaabbabbabbabababaabbbbaaaaaaabbabaababbbaab" "bbbbbaaabaaaabaaabbaabbaabbabaaabbbbabbbb"	""	""	   
"babbabbbbbabbaaaabbabaaababbbabbaaabbbabababbaaabbaabaababaabbbabbbabbbbabbabbaaaaabbaabbabbbabaaabbbaaaababaaaaaaabbabababababbaaaaaaaaaaaaaabaababbbaabbbaaabaabaaaabaabaabbbbabbaaba" "abaabbbbbbababbaabbbbaabbbbbaaabbabbaaabaaaabbabab"	""	""	   
"babababbaabaaabababbaaaaabaaababababbbabbbbaababbbbbbbbaaaaabaabbaabbbabaababbaaabababbababbabaabbbaabbabababbbba" "baaaaaabbbabbbaaaab"	""	""	   
"bbaabbbabbbabaababbbababbbbbbaaabaababbbabbbbbbbaaaababababbbabaaababbbaaabbaaaaaabaaaaababaaaaaaababaabbbabaabaaaaabba" "bbabaabaaaabbaaaaabaaa"	""	""	   
"abbbaababbaababbbaaababbabaaaabababbabbbabbbaaabaabbbaabaaaabbaabaabbbabbbabbaaabbbaaabaababaaabaaabbaaababbbbbabaababbbbbabbabaabbaaaabaaabbbbaabbababababbaabbaabaabbbbaabbabbbbaabba" "baaaabbabaaababbababbbbbab"	""	""	   
"aaabaabaaabbbbbbababbabbbbaabbabbaababbababbbbaaabbabbbaabbbabbbbbbbbababbbaaaaabaaabbababaaababbbaabaaababbabbbbababbbabaabbababbabbbbababbababbbaaababbb" "bbabbbaabbbbaabbaabbbabbab"	""	""	   
"aabbbabbbabbbabbababbaaabaaaabaabbbbaaabbbbababbbbaabaaaaababbbbbaabbaaabbaabababbabbbbbbabbaaabbaaaaaabaabbaaaababababbbaabbaaaaaaaa" "baaaabaabbaabaaabbababba"	""	""	   
"babbbbabaabbababaaaaaabaaaaabbbabbbaabaabbbbbbabbabaaaaaaaabbabbbabbbbaabbbabbbabaabaabababaaabbababaabbaabbbabaaabaaaababa" "bbbbaaababaabab"	""	""	   
"ababbbbbaababbbbaaabababaabaabababababaabbbbaaabaaabbaaaababaaaabababaabbbaababaabbabbabaaabaabaabaababaababbbbbaabbbbbabbbaaaaabaaaabbaababbbbbaabbaabbbabbbbaababaaaaabaaaabaabbbb" "bbabaaaaabbaab"	""	""	   
"aabbabaaaaabbababaaaaabaaaababbabababbabbbbabaaaabaabbbabbbbaababbaaaaaabbaabbababbbaababababbaaaaaaaaaabbaaabbaabbabbabbababbabbbbbbabbbabbbbbbaabbbaababbbaaabbbbababaabbbaaaababaaabab" "babbbaaaaabaabba"	""	""	   
"babbbbaababbaaaabbbbaaaabaaabababbbaabaaaabaaaaabbbbbbbababaaaabbbaabaababbbbbbbaaaaaaababaaaaabaabbabab" "baaabbabaababbaabaabaabababbaa"	""	""	   
"baabbaaaaaaabbaaaaabbabbababaabbabbbbbabbabbbbbbabababaabbbbbaaabbbbabaababababbbaabbbbaaabbaababbbaabaabbabbaaaabababaaabbabbababbabbaaabbbbabbbbabbabbaabbbaa" "bbaaaababa"	"bbaaaabababaaabbabbababbabbaaabbbbabbbbabbabbaabbbaa"	"bbaaaabababaaabbabbababbabbaaabbbbabbbbabbabbaabbbaa"	   
"aabbaaabbaabbaabaabaaaaaaabbbbbbbaabababbaaababbbbbbbabaaabbbabaabbaaabbabbbabbbaaababbabaababbaababbbabbabbbaabaaabbabaabbbabbbaaabbaaaabbbbbaabbbababbaaaababbabababaaabaabaaa" "bbabaabaaaaabb"	""	""	   
"baabbabbbbbaabbbaaaaaabaababbabaabbbbaabaabababaabaabbbabbbabaabababbbabbabaababaabaaaababbbbbbbabbbab" "bbaaabababa"	""	""	   
"bbaabbbaaabaabbbbaababbaabbaababaabbbaaaabaaabaababbbababaaaabbabbabbababbaaaaabbbbabaaabbabaabbbbaabbababbabbaaabbbbbbaaabaababaa" "aaababababbb"	""	""	   
"aaabbbaabbabaaabbabbaabbaabbbaabaababbabaaabbbaabbbbbaabbbaaaaaaababaaaabbbaababababbaaababbabaaaaaabaaaba" "bbaaaba"	"bbaaababbabaaaaaabaaaba"	"bbaaababbabaaaaaabaaaba"	   
"aaabaaabbbbbbabbbabbbbbbbbbbaaaaaababbaaabbbbbaabababababbbbbaabababbabbbbbbabbbbbbbbbbbababbaabaabbaaaabbbbbaaababbbbabaaab" "aabbbabaabbaabb"	""	""	   
"bbabbbaabbaabbbababbaabaaaaabbbbbaaabbabaababaaaabbabaabbbaaabbbbabbbbabbbbabbbbaababbbaababbaaaaabbbbabaabbbaaabbaab" "abbaaaabaaba"	""	""	   
"ababaabbbbababbaabaaabaabbaaaabbabaabbbbbbabbaabbabbbabbbbbaaabaababbbaabbbabbbaabbbbaaabbababbabbbabaaabbaabbabababbbaaaaaaababbabaababaabbbbaaabbbabb" "abbabbbabaa"	"abbabbbabaaabbaabbabababbbaaaaaaababbabaababaabbbbaaabbbabb"	"abbabbbabaaabbaabbabababbbaaaaaaababbabaababaabbbbaaabbbabb"	   
"baababbbabbaabbaabbaaaabbbbbbbaabbababbbaabbbbbaaaaaabaaabbabbaaaaabbbaabbbbaababbbbabbbaabbabaaaabbbbbababbbaaaabbaabbabaaba" "aaabbbbbbabb"	""	""	   
"abbabaaaabbbaabaabaabbbaaabaaaaaabbbabbaabbabaabbabaaaaababbabbaaaaabbbbaaabbaaabbbbabbbbaaabbaaaaababbaababbabaaabaabbbbbbbaabaabaabbbbababbbababbaaababbbabaabbaaabbbba" "bbbbbbaa"	"bbbbbbaabaabaabbbbababbbababbaaababbbabaabbaaabbbba"	"bbbbbbaabaabaabbbbababbbababbaaababbbabaabbaaabbbba"	   
"bbababaaaababbaabbbabbbaaabbbaaababbabaabbaaaaabbaaabbbbaaabaabbaababbbaabaaababbaaabbbbbbaabbbbbaaabbababaaaaabaabbbababbaababaabbaa" "bbabba"	""	""